12
3,7,5,5,5,5,5,5,5,5,7,6
9,13,5,5,5,5,5,5,5,5,15,14
3,7,5,5,5,5,5,5,5,4,11,14
11,14,1,5,5,5,5,5,5,5,15,14
11,15,5,5,5,5,5,5,5,5,15,14
9,13,5,5,5,7,7,5,5,4,9,14
3,7,5,5,5,13,13,5,5,5,7,14
11,15,5,5,5,5,5,5,5,5,15,14
11,15,5,5,5,5,5,5,5,5,15,14
11,15,5,5,5,5,5,5,5,5,15,14
11,15,5,5,5,5,5,5,5,5,15,14
9,13,5,5,5,5,5,5,5,5,13,12