30
3,5,4,2,2,3,5,5,5,5,5,5,4,3,5,4,3,4,3,5,5,4,3,6,1,7,4,1,7,4
11,5,4,10,11,13,7,7,7,4,2,2,2,10,3,5,13,5,14,3,5,7,12,8,2,11,7,5,12,2
10,3,5,13,13,6,8,10,9,5,12,11,13,12,11,5,7,4,9,13,4,9,4,1,15,12,9,6,3,12
11,15,7,7,4,8,2,9,4,3,7,13,5,4,11,4,8,2,2,3,4,2,3,4,11,7,6,11,13,4
10,10,10,11,5,4,11,4,2,8,11,5,5,5,14,3,4,11,13,12,2,10,10,2,10,8,8,8,3,4
10,8,8,11,4,3,12,2,11,4,11,4,3,4,11,12,3,13,5,4,10,10,11,13,13,5,5,4,10,2
11,4,1,15,7,13,7,12,11,5,13,5,12,2,8,2,11,5,5,7,15,13,15,5,5,7,5,6,11,14
10,3,5,14,11,6,9,7,12,2,3,7,6,11,6,11,13,6,2,8,8,1,15,7,6,8,1,13,14,8
10,9,6,8,10,8,1,15,7,14,10,10,8,10,9,13,4,9,15,7,4,1,14,8,11,5,5,4,9,6
11,6,8,1,13,7,6,8,8,11,14,11,7,13,6,2,3,4,8,8,3,4,8,1,13,5,7,4,2,10
10,11,4,1,7,12,11,7,4,10,10,8,11,4,11,13,13,5,5,4,10,3,5,4,2,3,13,4,10,8
8,10,1,6,10,3,12,11,6,10,8,3,15,6,9,5,5,7,6,3,12,10,2,3,12,8,3,7,13,6
3,14,2,9,14,11,6,8,10,9,6,8,10,9,5,5,4,10,9,13,4,11,15,15,4,2,10,9,4,8
8,8,9,6,8,10,8,1,14,2,10,1,13,6,3,4,1,14,3,7,5,12,8,10,3,15,15,4,3,4
1,5,6,9,7,15,7,6,11,12,9,4,2,11,15,6,2,11,14,10,3,4,2,8,10,8,8,3,15,4
1,7,15,7,12,10,10,8,11,5,7,6,11,14,11,13,14,8,8,8,11,5,15,7,13,7,7,14,9,4
1,14,10,8,1,14,8,3,14,1,12,8,8,10,8,1,15,7,5,5,15,4,8,11,4,10,8,10,3,4
3,12,8,3,5,15,4,8,9,7,6,2,1,14,2,2,10,10,3,4,9,6,2,9,4,9,4,9,12,2
10,3,5,12,3,15,7,4,1,14,11,13,4,9,15,12,8,11,15,4,1,14,10,3,5,6,3,5,5,14
8,10,3,7,14,8,10,1,7,12,11,7,4,1,12,3,6,8,11,4,1,15,15,13,6,10,9,6,2,10
3,14,8,10,8,1,15,6,9,6,10,9,7,7,5,12,8,3,14,1,5,14,11,6,8,8,3,13,12,8
8,8,1,14,1,5,14,10,1,14,8,3,14,11,7,7,4,8,11,4,1,14,10,11,5,5,13,5,5,4
1,5,6,8,2,1,14,8,2,11,4,10,10,10,10,9,4,2,8,3,7,12,10,11,7,4,3,7,5,6
2,2,9,7,15,7,15,5,12,9,6,10,8,10,10,2,2,11,5,14,11,6,10,8,11,5,12,9,4,8
9,15,5,14,8,10,11,5,6,2,10,11,6,8,9,15,14,8,3,14,8,10,8,3,13,7,5,5,5,6
1,12,3,14,1,14,10,3,15,12,10,10,9,7,4,10,10,1,12,11,6,11,6,10,1,13,5,6,2,10
1,5,14,8,1,14,8,10,9,6,8,9,6,11,4,8,8,3,5,12,8,10,8,11,5,7,6,11,12,8
1,7,15,6,3,12,1,12,1,15,7,4,8,9,5,7,6,11,4,1,5,15,6,9,6,8,8,11,5,6
3,14,8,8,10,3,6,1,5,14,9,7,4,3,6,8,8,9,5,6,3,14,9,6,9,5,4,10,2,8
8,9,4,1,12,8,9,5,5,13,4,9,5,12,9,5,5,5,4,8,8,8,1,13,5,5,4,9,13,4