16
3,7,7,7,7,7,7,7,7,7,7,7,7,7,7,6
11,15,15,15,15,15,15,15,15,15,15,15,15,15,15,14
11,15,15,15,15,15,15,15,15,15,15,15,15,15,15,14
11,15,15,15,15,15,15,15,15,15,15,15,15,15,15,14
11,15,15,15,15,15,15,15,15,15,15,15,15,15,15,14
11,15,15,15,15,15,15,15,15,15,15,15,15,15,15,14
11,15,15,15,15,15,15,15,15,15,15,15,15,15,15,14
11,15,15,15,15,15,15,15,15,15,15,15,15,15,15,14
11,15,15,15,15,15,15,15,15,15,15,15,15,15,15,14
11,15,15,15,15,15,15,15,15,15,15,15,15,15,15,14
11,15,15,15,15,15,15,15,15,15,15,15,15,15,15,14
11,15,15,15,15,15,15,15,15,15,15,15,15,15,15,14
11,15,15,15,15,15,15,15,15,15,15,15,15,15,15,14
11,15,15,15,15,15,15,15,15,15,15,15,15,15,15,14
11,15,15,15,15,15,15,15,15,15,15,15,15,15,15,14
9,13,13,13,13,13,13,13,13,13,13,13,13,13,13,12